stem	KEYWORD1
Robot	KEYWORD1
displayLCD	KEYWORD2
clearLCD	KEYWORD2
moveMotor	KEYWORD2
setEncoderTarget	KEYWORD2
getMotorEncoder	KEYWORD2
resetMotorEncoder	KEYWORD2
wait	KEYWORD2
getSensorValue	KEYWORD2
motorL	LITERAL1
motorR	LITERAL1
motorP	LITERAL1
stopMotors	LITERAL1
touchSensor	LITERAL1
ultrasonic	LITERAL1
lineDetectorLeft	LITERAL1
lineDetectorRight	LITERAL1
LED_BUILTIN1	LITERAL1
LED_BUILTIN2	LITERAL1
LED_BUILTIN3	LITERAL1
LED_BUILTIN4	LITERAL1